24 30
2 2 2 2 2 2 2 2 2 2 2 2 2 2 2 2 2 0 0 0 0 0 0 0
2 2 2 2 2 2 2 2 2 2 2 2 2 2 2 2 2 18 19 0 0 0 15 0
2 2 2 2 2 2 2 2 2 2 2 2 2 2 2 2 2 17 17 19 0 0 0 0
7 7 7 7 22 7 7 7 7 2 2 2 2 2 2 2 2 16 16 16 0 0 0 0
7 2 2 2 2 2 2 2 7 2 2 2 2 2 2 2 2 22 16 16 1 0 0 0
7 2 2 2 2 2 2 2 7 2 2 2 2 2 2 2 2 14 14 14 14 0 0 0
7 2 2 2 2 2 2 2 7 2 2 2 2 2 2 2 2 0 0 0 0 0 0 0
22 2 2 2 2 2 2 2 22 2 2 2 2 2 2 2 2 0 0 0 8 8 8 0
7 2 2 2 2 2 2 2 7 2 2 2 2 2 2 2 2 0 0 0 8 8 8 0
7 2 2 2 2 2 2 2 7 2 2 2 2 2 2 2 2 8 0 0 0 7 0 0
7 2 2 2 2 2 2 2 7 2 2 2 2 2 2 2 2 8 0 0 0 12 0 0
7 7 7 7 22 7 7 7 7 2 2 2 2 2 2 2 2 0 0 0 0 0 0 0
2 2 2 2 2 2 2 2 2 2 2 2 2 2 2 2 2 6 0 0 0 0 0 0
2 2 2 2 2 2 2 2 2 2 2 2 2 2 2 2 2 0 0 0 0 0 10 0
2 2 2 2 2 2 2 2 2 2 2 2 2 2 2 2 2 0 0 0 0 0 0 0
2 2 2 2 2 2 2 2 2 2 2 2 2 2 2 2 2 0 0 0 0 0 0 0
2 2 2 2 2 2 2 2 2 2 2 2 2 2 2 2 2 17 17 17 19 0 0 0
0 8 8 8 0 0 0 0 7 0 0 0 13 0 0 0 16 16 16 16 16 0 0 0
0 8 8 8 0 0 0 0 12 0 0 0 0 0 0 0 16 16 16 21 16 0 0 0
0 0 7 0 0 0 15 0 0 0 0 0 0 0 0 14 16 22 16 16 16 1 0 0
0 0 12 0 0 0 0 0 0 0 0 0 0 0 0 14 14 14 14 14 14 14 0 0
0 0 0 0 0 0 0 0 8 8 8 0 0 0 0 14 14 14 14 14 14 14 0 0
0 0 0 0 0 0 0 0 8 8 8 0 0 0 0 0 0 0 0 0 0 0 0 0
0 0 18 17 17 17 19 0 0 7 0 0 8 8 8 0 0 0 0 0 0 0 3 0
0 0 16 16 16 16 16 0 0 12 0 0 8 8 8 0 0 10 10 10 0 0 0 0
0 0 16 20 16 21 16 0 0 0 0 0 0 7 0 0 0 10 10 10 0 0 0 0
0 14 16 16 22 16 16 1 0 0 0 0 0 12 0 0 0 0 0 0 0 0 0 0
0 14 14 14 14 14 14 14 0 0 0 0 0 0 0 0 0 0 0 0 0 0 0 0
2 2 2 2 2 2 2 2 2 2 2 2 2 2 2 2 2 2 2 2 2 2 2 2
23 23 23 23 23 23 23 23 23 23 23 23 23 23 23 23 23 23 23 23 23 23 23 23